1111111111111111111111111111111111
100P00000000C0111000011000000000E1
1110010100100000101111110111100011
1110010010101010001011100011110101
1110010001001000000000010000000C01
111001000100100000C000010000100001
1110010001001000011100110111000011
111C01000100100000C00001000000C001
111001000100100C001000010000100001
1110010001001000001000010000000001
1110010001001000001000010011111101
1110010001000000000000010000000001
1110010001000000C00000000000000001
1110010001C00011111000010000000C11
1111111111111111111111111111111111